[capellambse.diagram.formats]
datauri_svg = capellambse.model.diagram:SVGDataURIFormat
html_img = capellambse.model.diagram:SVGInHTMLIMGFormat
png = capellambse.model.diagram:PNGFormat
svg = capellambse.model.diagram:SVGFormat
svg_confluence = capellambse.model.diagram:ConfluenceSVGFormat
svgdiagram = capellambse.model.diagram:convert_svgdiagram
termgraphics = capellambse.model.diagram:TerminalGraphicsFormat

[capellambse.filehandler]
file = capellambse.filehandler.local:LocalFileHandler
git = capellambse.filehandler.git:GitFileHandler
glart = capellambse.filehandler.gitlab_artifacts:GitlabArtifactsFiles
http = capellambse.filehandler.http:HTTPFileHandler
https = capellambse.filehandler.http:HTTPFileHandler
zip = capellambse.filehandler.zip:ZipFileHandler

[capellambse.model_extensions]
filtering = capellambse.extensions.filtering:init
pvmt = capellambse.extensions.pvmt:init
reqif = capellambse.extensions.reqif:init
validation = capellambse.extensions.validation:init

[capellambse.namespaces]
activity = capellambse.metamodel.namespaces:ACTIVITY
behavior = capellambse.metamodel.namespaces:BEHAVIOR
capellacommon = capellambse.metamodel.namespaces:CAPELLACOMMON
capellacore = capellambse.metamodel.namespaces:CAPELLACORE
capellamodeller = capellambse.metamodel.namespaces:CAPELLAMODELLER
capellarequirements = capellambse.extensions.reqif:CapellaRequirementsNS
cs = capellambse.metamodel.namespaces:CS
epbs = capellambse.metamodel.namespaces:EPBS
fa = capellambse.metamodel.namespaces:FA
filtering = capellambse.extensions.filtering:NS
information = capellambse.metamodel.namespaces:INFORMATION
information_communication = capellambse.metamodel.namespaces:INFORMATION_COMMUNICATION
information_datatype = capellambse.metamodel.namespaces:INFORMATION_DATATYPE
information_datavalue = capellambse.metamodel.namespaces:INFORMATION_DATAVALUE
interaction = capellambse.metamodel.namespaces:INTERACTION
la = capellambse.metamodel.namespaces:LA
libraries = capellambse.metamodel.namespaces:LIBRARIES
metadata = capellambse.metamodel.namespaces:METADATA
modellingcore = capellambse.metamodel.namespaces:MODELLINGCORE
oa = capellambse.metamodel.namespaces:OA
pa = capellambse.metamodel.namespaces:PA
pa_deployment = capellambse.metamodel.namespaces:PA_DEPLOYMENT
pvmt = capellambse.extensions.pvmt:NS
re = capellambse.metamodel.namespaces:RE
requirements = capellambse.extensions.reqif:RequirementsNS
sa = capellambse.metamodel.namespaces:SA
shared_model = capellambse.metamodel.namespaces:SHARED_MODEL
viewpoint = capellambse.model.diagram:VIEWPOINT_NS

[console_scripts]
capellambse = capellambse.__main__:main
